25 20
#############
#...........#    ########
#.....s.....######......#
#...................c...#
#.....s.....######......#
#...........#    #......#
#...........#    #......#
#...........#    #.....!#
#####..######    ########
    #..#
    #..#
    #..#
  ###..#################
  #....................#
  #.......########.....#
  #.......#      #.....#
  #.......#      #.....#
  #.......#      #.....##
  #......e#      #.....u#
  #########      ########
