25 20
&&&&&&&&&&&&&
&...........&    &&&&&&&&
&.....s.....&&&&&&......&
&...................c...&
&.....s.....&&&&&&......&
&...........&    &......&
&...........&    &......&
&...........& %r &.....!&
&&&&&..&&&&&& r  &&&&&&&&
    &..&
$r  &..&     $r
r   &..&     r
  &&&..&&&&&&&&&&&&&&&&&
  &....................&
  &.......&&&&&&&&.....&
  &.......&      &.....&
  &.......&    %r&.....&
  &.......&    r &.....&&
  &......e&      &.....u&
  &&&&&&&&&      &&&&&&&&
